#this is the first level



0,0,0,0,0,0,0,0,0,0,0,0,0,0,0
0,42,49,42,49,42,49,42,49,42,49,42,49,42,0
0,49,42,0,42,0,42,0,42,0,42,0,42,49,0
0,42,49,42,49,42,49,42,49,42,49,42,49,42,0
0,49,42,0,42,49,42,0,42,49,42,0,42,49,0
0,42,49,42,49,42,0,42,0,42,49,42,49,42,0
0,49,42,0,42,49,42,0,42,49,42,0,42,49,0
0,42,49,42,49,42,49,42,49,42,49,42,49,42,0
0,49,42,0,42,0,42,0,42,0,42,0,42,49,0
0,42,49,42,49,42,49,42,49,42,49,42,49,42,0
0,0,0,0,0,0,0,0,0,0,0,0,0,0,0
