0,0,0,0,0,0,0,0,0,0,0,0,0,0,0
0,54,54,54,54,54,54,54,54,54,54,54,54,54,0
0,54,0,44,48,44,0,44,48,44,0,44,48,54,0
0,54,44,0,44,48,44,0,44,48,44,0,44,54,0
0,54,48,44,0,44,48,44,0,44,48,44,0,54,0
0,54,44,48,44,0,44,48,44,0,44,48,44,54,0
0,54,0,44,48,44,0,44,48,44,0,44,48,54,0
0,54,44,0,44,48,44,0,44,48,44,0,44,54,0
0,54,48,44,0,44,48,44,0,44,48,44,0,54,0
0,54,54,54,54,54,54,54,54,54,54,54,54,54,0
0,0,0,0,0,0,0,0,0,0,0,0,0,0,0
